$############################################################
.........#..............#...........#...........#..#........#
#..#######..#..#..#..##########..####..####..####..####..#..#
#.....#..#..#..#..#..#..#...........#..#.....#.....#..#..#..#
#..#..#..#######..#..#..####..##########..####..#..#..#..####
#..#..............#.....#..#.....#...........#..#...........#
#..#..#..#############..#..####..#######..####..####..####..#
#..#..#...........#.....#....................#.....#.....#..#
#######..####..##########..####..#######..#######..#..####..#
#.....#.....#........#.....#..#..#..............#..#.....#..#
####..#..#######..#..####..#..####..#..####..#..#..####..####
#.....#..#.....#..#.....#..#.....#..#..#.....#........#.....#
#..#..#..#..##########..#######..####..##########..#######..#
#..#...........#...........#.....#........#..#..#..#..#.....#
#..#..#..####..####..####..#..####..#..#..#..#..####..####..#
#..#..#.....#..#..#..#........#.....#..#..............#.....#
#..#############..####..####..#..#######..#..#######..#..####
#..#...........#...........#...........#..#........#..#..#..#
#..#..#######..#######..##################################..#
#..#..#........#...........#.....#...........#..............#
#..####..##########..##########..####..#..####..####..#..####
#..#.................#..............#..#........#..#..#..#..#
#..#############..#######..#############..#######..#######..#
#........#..#...........#..............#..#.....#.....#.....#
##########..#..##########..####..#######..#..####..#..#..####
#.................#.....#..#..#.....#..............#........#
#..####..#..##########..#..#..#..##########..#..#######..####
#.....#..#..#..#........#..#.....#..#..#.....#........#..#..#
#..#..#######..#######..####..#..#..#..#..####..####..#..#..#
#..#..#........#..#..#........#.....#........#.....#..#..#..#
#..#..#######..#..#..####..#..#######..####..#..#######..#..#
#..#..#.....#.....#........#........#.....#..#..#...........#
#..#..#..####..#..#######..####..####..#..################..#
#..#...........#..#..#..#..#..#........#.....#...........#..#
#############..####..#..####..#..#..################..####..#
#........#.....#.................#..#...........#...........#
####..####..#..#..####..#######..#############..#..#######..#
#........#..#.....#..#........#..#..#..#.................#..#
####..####..#######..#..####..#..#..#..####..#..#..####..#..#
#..............#........#.....#........#.....#..#..#.....#.@
############################################################
